0 0 0 0 0 0 6 1 7 0 0 0 0 0 0
0 0 0 0 2 2 2 0 2 2 2 0 0 0 0
0 0 1 1 1 0 0 0 0 0 8 1 1 0 0 
2 2 2 0 0 0 0 0 0 0 0 0 2 2 2
0 0 8 1 1 0 0 0 0 0 1 1 1 0 0
0 0 0 0 2 2 2 0 2 2 2 0 0 0 0
0 0 0 0 0 0 1 1 1 0 0 0 0 0 0
0 0 0 0 0 0 0 0 0 0 0 0 0 0 0

# 0 -- no brick
# 1 -- normal brick
# 2 -- double brick
# 3 -- double brick second hit
# 4 -- increase paddle speed
# 5 -- decrease paddle speed
# 6 -- increase paddle size
# 7 -- decrease paddle size
# 8 -- fire ball